row_id,r,u,v
2,1,0x00000001,0x80080000
135,1,0x0000b000,0x00000900
203,1,0x00900000,0x08080000
254,1,0x10000000,0x08000000
259,1,0x30000000,0x03000000
260,1,0x30000000,0x0c000000
275,1,0x90000000,0x08000000
276,1,0x90000000,0x0c000000
