row_id,r,u,v
103750,3,0x00000090,0x040b1332
110616,3,0x00009000,0x05051110
122343,3,0x000b0000,0x04aa3003
122409,3,0x000b0000,0x05eec00c
125533,3,0x000f0000,0x0b665005
125624,3,0x000f0000,0x0d668008
133087,3,0x60600000,0x60060600
135315,3,0xa0000000,0xe11f0404
